NO textures/north.xpm
SO textures/south.xpm
WE textures/west.xpm
EA textures/west.xpm

C 0,0,118
F 0,97,32

111111111111111111111111111111111111111111111111111111111111111111
100000000000000000000000000000000000000000000000000000000000000001
100000011110000000000000000000000000000000000000000000000000000001
100000010001000000000011111111110000000000000000001000000000000001
100000010001000000000000001000000000110000000000001000N00000000001
100000011100001000010000001000000001001000000000001000000000000001
100000010000001000010000001000000010000100000000001000000000000001
100000010000001000010000001000000011111100000000001000000000000001
100000010000001000010000001000000100000010000000000000000000000001
100000010000000111100000001000001000000001000000001000000000000001
100000000000000000000000000000000000000000000000000000000000000001
111111111111111111111111111111111111111111111111111111111111111111
100000011100001000010000001000000001001000000000001000000000000001
100000010000001000010000001000000010000100000000001000000000000001
100000010000001000010000001000000011111100000000001000000000000001
100000010000001000010000001000000100000010000000000000000000000001
100000010000000111100000001000001000000001000000001000000000000001
100000000000000000000000000000000000000000000000000000000000000001
111111111111111111111111111111111111111111111111111111111111111111
111111111111111111111111111111111111111111111111111111111111111111
100000011100001000010000001000000001001000000000001000000000000001
100000010000001000010000001000000010000100000000001000000000000001
100000010000001000010000001000000011111100000000001000000000000001
100000010000001000010000001000000100000010000000000000000000000001
10000001000000011110000000100000100000000100000001000000000000001
100000000000000000000000000000000000000000000000000000000000000001
111111111111111111111111111111111111111111111111111111111111111111
111111111111111111111111111111111111111111111111111111111111111111
100000011100001000010000001000000001001000000000001000000000000001
100000010000001000010000001000000010000100000000001000000000000001
100000010000001000010000001000000011111100000000001000000000000001
100000010000001000010000001000000100000010000000000000000000000001
100000010000000111100000001000001000000001000000001000000000000001
100000000000000000000000000000000000000000000000000000000000000001
111111111111111111111111111111111111111111111111111111111111111111
111111111111111111111111111111111111111111111111111111111111111111
100000011100001000010000001000000001001000000000001000000000000001
100000010000001000010000001000000010000100000000001000000000000001
100000010000001000010000001000000011111100000000001000000000000001
100000010000001000010000001000000100000010000000000000000000000001
100000010000000111100000001000001000000001000000001000000000000001
100000000000000000000000000000000000000000000000000000000000000001
111111111111111111111111111111111111111111111111111111111111111111