
  


  NO         textures/west.xpm            



     SO                       textures/west.xpm   
WE textures/west.xpm  
EA textures/west.xpm       

F  164, 169, 20
C 153,204,255

     
111111111111111111111111111111111111111111111111111111111111111111
100000000000000000000000000000000000000000000000000000000000000001
100000011111000000000000000000000000000000000000000000000000000001
100000010000100000000000000000000000000000000000000000000000000001
1000000100001000000000000000000000000000000000000000000N0000000001
100000011100000000000000000000000000000000000000000000000000000001
100000010000000000000000000000000000000000000000000000000000000001
100000010000000000000000000000000000000000000000000000000000000001
100000010000000000000000000000000000000000000000000000000000000001
100000010000000000000000000000000000000000000000000000000000000001
100000000000000000000000000000000000000000000000000000000000000001
111111111111111111111111111111111111111111111111111111111111111111
