
  


  NO         textures/west.xpm            



     SO                       textures/west.xpm   
WE textures/west.xpm  
EA textures/west.xpm       

F  164, 169, 20
C 153,204,255

     
111111111111111111111111111111111111111111111111111111111111111111
100000000000000000000000000000000000000000000000000000000000000001
100000011111000000000000000000000000000000000000000000000000000001
1000000100001000000N00000000000000001111111111000000000000000000001
100000010000100000000010000000100000000100000001111111000000000001
100000011110000001000010000000100000000100000001000010000000000001
10000001000000000D0F0010000000100000000100000001111110000000000001
100000010000000001000010000000100000000100000001000010000000000001
100000010000000000000011111111100000000100000001000010000000000001
100000010000000000000000000000000000000000000000000000000000000001
1000000000000000000000000D0000000000000000000000000000000000000001
111111111111111111111111111111111111111111111111111111111111111111
