
  


  NO         textures/simonkraft/NO_sponge.xpm



     SO                      textures/simonkraft/SO sponge.xpm



WE textures/simonkraft/WE_sponge.xpm
EA textures/simonkraft/EA_sponge.xpm

F 164,169,20
C     153,       204,    256


 1111111111111111111
10000010000000000101
10000010000000000101
10000010000001111101
1000000000N0000001
10000000000000100111111111111
10000000000000100000000000001           
11111111111111111111111111111 
1111111111111111111111111111
