111111111111111111
100000100000000001
100000100000000001
100000100000011111
1000000000N0000001
10000000000000100111111111111
10000000000000100000000000001           
11111111111111111111111111111                                                        
