NO ./textures/north.xpm
SO ./textures/south.xpm
WE ./textures/west.xpm
EA ./textures/east.xpm

C 35,19,73
F 15,6,40

111111111111111
111111000111111
111110000011111
1111000N0001111
111000000000111
110000000000011
1D0001111100001
110000111000011
1110000100F0111
111100000001111
111110000011111
111111000111111
111111111111111

