F 76,76,76
C 99,99,99

NO ./textures/Wall1.xpm
SO ./textures/Wall2.xpm
WE ./textures/Wall3.xpm
EA ./textures/Wall1.xpm

1111111111111111111
10W1001001001000001
1011000001000001001
1001001FF11111D1111
1001111000001001001
1000D0000000D001001
1001111111111001001
1111000000000001011
1000000001000000001
1111111111111111111

