F 76,76,76
C 99,99,99

NO ./textures/Wall1.xpm
SO ./textures/Wall2.xpm
WE ./textures/Wall3.xpm
EA ./textures/Wall1.xpm

1111111111111111111
10W1001001001000001
1D11000001000001001
1001001001111101111
10F1111000001001001
100D000000000001001
10F1111111111001001
1111000000000001011
1000000001000000001
1111111111111111111

