
NO ./textures/west.xpm
SO ./textures/south.xpm
WE ./textures/south.xpm
EA ./textures/south.xpm

F 0,120,0
C 0,0,120

1111111111111111111111111111111111111
1011000000000000000000000000000000001
1001000000000000000000000000000000001
1001100000000000000000000000000000001
1000000000010000000000000000000000001
1111100000010000000W00000000000000001
1000000000010000000000000000000000001
1001000000000000000000000000100000001
1000000000000000000000000001100000001
1111000000000000000000000000100000001
1011000000000011111000000000000000001
1011000000000000000000000000000000001
1011000000100000000011000000000000001
1011000000100000000000000000000000001
1011000000100000000000000000000000001
1011000000100000000000000000000000001
1011000000100011111000000000000000001
1011000000000000000000000000000000001
1011000000000000000000000000000000001
1011000000000001110000000000000000001
1011000000000000100000000000000000001
1011000000000000110000000000000000001
1011000000000000010000000000000000001
1011000000000000010000000000000000001
1011000000000000010000000000000000001
1011000000000000001000000000000000001
1011000000000000000010000000000000001
1011000000000000001000000000000000001
1011000000000000000000000000000000001
1011000000000000000000000000000000001
1011000000000000000000000000000000001
1011000000000000000000000000000000001
1011000000000000000000000000000000001
1011000000000000000000000000000000001
1011000000000000000000000000000000001
1011000000000000000000000000000000001
1011000000000000000000000000000000001
1011000000000000000000000000000000001
1011000000000000000000000000000000001
1111111111111111111111111111111111111