NO textures/north.xpm
SO textures/south.xpm
WE textures/west.xpm
EA textures/east.xpm

F 20,20,20
C 200,200,200

111111111111111111111
1W00000000D00F00D0001
111111111111111111111
