NO ./textures/north.xpm
SO ./textures/south.xpm
WE ./textures/west.xpm
EA ./textures/east.xpm

F 164,169,20
C 153,204,255

    11  111111111111  1111111111    11  1111111111    11  1111111111    11  1111111111    11  1111111111    11  1111111111    11  1111111111    11  1111111111    11  1111111111    11  1111111111    11  1111111111
   1001  10000001
  100001  100001
 1000N001  1001
1111111111  11